#############################        ###########################
#                                                              #
#            #      #                                          #
#            #      #                                          #
#            #      #                                          #
#            #      #                                          #
#            #      #                      #       #           #
#                                          #       #           #
#                                          #       #           #
                                           #       #            
                                           #       #            
                                                              
                                              
#                                                              #
#                                                              #
#                ################################              #
#                                                              #
#                                                              #
#                ################################              #
#                                                              #
#                                                              #
#                                                              #
#############################        ###########################